a	a
ah	ah
au	au
ay	ay
b	b
c	c
cl	cl
ct	ct
d	d
dj	dj
e	e
f	f
g	g
gr	gr
i	i
ie	ie
iu	iu
j	j
l	l
m	m
n	n
ng	ng
nt	nt
o	o
oh	oh
p	p
r	r
s	s
t	t
tr	tr
ts	ts
u	u
uo	uo
v	v
x	x